          10
          nAO  ---  atom
           1           1
           2           1
           3           1
           4           1
           5           1
           6           2
           7           2
           8           2
           9           2
          10           2
